111111111111
000010000011
111010111011
100000100011
101110101111
101000100011
101010101011
101010101011
101010101011
100010101000
100000000001
111111111111
